#########################
#                       #
#                       #
#      @                #
#                       #
#                       #
#             x         #
#                       #
#                       #
#                       #
#                       #
#  #####  #   ####  #   #
#    # M      #   x #   #
#    #    #   ####  #   #
#    #    #      #      #
#    #    #  #####  #   #
#                       #
#########################
