#########################
#                       #
#                       #
#      @                #
#                       #
#                       #
#             x         #
#                       #
#                       #
#                       #
#                       #
#                       #
#      M          x     #
#                       #
#                       #
#                       #
#                       #
#########################
